1111111111111
10010000CCCC1
1000011111001
1PE0110000011
1111111111111
