11111111111111111111111111111111
1C0000000C00000C0000000000000001
10C00111110C00000C00000000000001
1P0011E00C0100C00001C0C000000001
11111111111111111111111111111111
